1111111111111111111111111111111111111111
1P000000000000000000000000000000000000E1
1011111111101111111111111111111111111101
1000000000100000000000000000000000000001
1111011110101111111111110111111111111101
1C00010001000000000000001000000000000C01
1111110110111111011111110111111111111101
1000000100000000010000000100000000000001
1011111101111111010111111101111111111101
1000000001000000000100000001000000000001
1111111111111111111111111111111111111111
